wizard statue - Ignas @ sketchfab
textures - https://3dtextures.me/
monk - immensiveclipt @ sketchfab
artnouveau door - MightyPinecone @ sketchfab
medieval door - fabri_iorio @ sketchfab
medival_window - fresherator2 @ sketchfab
stained glass windows - Amatsukast @ sketchfab
extractor / pans / material - rkikon @ sketchfab
coal sack, barrel & bucket - PaulCarstens @ sketchfab
old faucet - rengokukyojuro @ sketchfab
metal sink pipe - VIS-All-3D @ sketchfab
kithcen pack - insya @ sketchfab
old wood table - Friederike Gr√∂pler @ sketchfab
long wood table - GetDeadEntertainment @ sketchfab
wood trelis - FrancescoMilanese @ sketchfab
fruit - Meerschaum Digital @ sketchfab
bread stuff - Meerschaum Digital @ sketchfab
steak - horse_water @ sketchfab
pour sound - TanwerAman @ pixabay
flowing sound - Dia_Pazon @ pixabay
lantern01 - Alexey.inc @ sketchfab
broom01 - JmPrsh153 @ sketchfab
crate01 - NeverSleep @ sketchfab
beanbag- kane_sk06 @ sketchfab
crystal model - Vergil190202 @ sketchfab
round table / wood chair - vilsonpistori @ sketchfab
bed - Maxmalow @ sketchfab
wardrobe - lagesnpiet @ sketchfab
desk - Alf Does Stuff @ sketchfab
drawer - SrMsantG @ sketchfab
coathanger - plaggy @ sketchfab
wall break sound - LordSonny @ pixabay
teleport sound - freesound_community @ pixabay
water splash sound - Universfield @ pixabay
skeleton - LasquetiSpice @ pixabay